18 60
                          ####                             
                       ###########                         
             ######################                        
         ###########################                       
                 ###################                       
                   ####################                    
                    ##########################             
                  ###############################          
                 ##########################################
              #############################################
            #############################################==
        ################################################===
################=====                   ===#############===
#############===                           ===##########===
############==                              ===########====
###############===                          ===########====
##################===                   =====##########====
#######################========###=====###############=====
