39 100
                                                                                                    
                                                                                                    
                                                                                                    
                                                                                                    
                                                                                                    
                                                                                                    
                                                                                                    
                                                                                                    
                                      ###                                                           
                                     #####                                                          
#===########             ====###############                                                        
###==##########      ########################                                                       
#################  ##########################                                                       
##############################################                                                      
##################################################                                                  
##########################             ###########################                                  
###############################            #################################                        
###################=#########     #          #####################################                  
###################==########     ##################################################                
####################=######     ######################################################              
####################################################################################                
########################################################################         ###                
########################################################################           ###              
#######################################################################             #               
######################################################################                              
#####################################################################                               
###################################################################                                 
###################################################################                                 
##################################################################                                  
##################################################################                                  
##################################################################                               ###
##################################################################                             #####
##################################################################                            ######
##################################################################                          ########
##################################################################                        ##########
##################################################################                      ############
##################################################################                     #############
##################################################################                    ##############
##################################################################                  ################

