39 136
                                                                                                                                        
                                                                                                                                        
                                                                                                                                        
                                                                                                                                        
                                                                                      ###########                                       
                                                                              ########################                                  
                                                                        ############################                                    
                                                                            #####################                                       
                                      ###                                                                                               
                                     #####                                                                                             #
#===########             ====###############                                                                                          ##
###==##########      ########################                                                                                         ##
#################            ################                                                                                        ###
#################              #####################                                                                               #####
##################                      ####################                                                                    ########
##########################             ###########################                                                        ##############
###############################            #################################                                          ##################
###################=#########     #          #####################################                               #######################
##################                              ######################################## ###############################################
##############                                          ##############################################                       ###########
################                                               ################################                                 ########
###################                            ########     ###############         ###                                            #####
#####################========               #########                    #           ###                                              ##
##############################################                                   #                                                     #
######################################################################                                                                 #
#####################################################################                                                                   
###################################################################                                                                     
###################################################################                                       ###                           
##################################################################                                      #########                       
##################################################################                                  ###############                     
##################################################################                               #####################                  
##################################################################                             ############################             
##################################################################                            ##################################        
##################################################################                          ######################################      
##################################################################                        #########################################     
##################################################################                      ############################################    
##################################################################                     ###############################################  
##################################################################                    ##################################################
##################################################################                  ####################################################

